
1
Grass(2x2)
-620.475,-663.6
Grass
491,1237
      rf                |
     <->                |
                        |
               s        |
R             <->       |
>                       |
          <>            |
    <->                 |
          B        =    |
         <>             |
->                      |
                       b|
             s       <--|
   <->      <-->        |
        =               |
             L          |
_____________~__________|
